# # # # # # #
#           #
#           #
# 5       5 #
#           #
#           #
# # # # # # #