# # # # # # # # # # #
# 8       8       8 #
#                   #
#     t       t     #
#                   #
# 8       t       8 #
#                   #
#     t       t     #
#                   #
# 8       8       8 #
# # # # # # # # # # #