# # # # # # #
#           #
#           #
#     H     #
#           #
#           #
# # # # # # #