# # # # # # # # # # # # # # # # # # # # #
#                                       #
#                   5     H           8 #
#                                       #
# # # # # # # # # # # # # # # # # # # # #