# # # # # # # # #
# G     t       #
#               #
#               #
# t     t     t #
#               #
#               #
#       t       #
# # # # # # # # #